OOOOWOEOOO
OPOOWOOOOO
OOBOOOOOOO
OOOODOOOOO
OOWWWOOOBO
OOAOWOOOOO
OOOOWWWOWW
OOOOOOOOOO
OOOBOOOROO
OCOOOEOOOO