ORWOOOOOOO
OOWOOOOOOO
OOWOOWWWRO
OOWEOODWOO
OOWOOOOWOO
OOWOOPOWOO
OOWDOOOWOO
OOWWWWWWOO
OOOOOOOOOO
OOOOOOOORO
