OOOEOOOOOO
OBOOOOOOOO
OOOOOOOROO
OOOOOOOOOO
OOOOPOOOBO
OOOOODOOOO
OROOOOOOOO
OOOOOOOOOO
OOOOOOOOOO
OOOOCOEOOO