ROOOOOEOOOOOOOR
OOOOOOOOOOOOOOO
OOOOOOOOOOOOOOO
OOODOOOOOOODOOO
OOOOWWWOWWWOOOO
OOOOWBOOOOWOOOO
EOOOWOBOOOWOOOO
OOOOOOOPOOOOOOC
OOOOWOOOBOWOOOO
OOOOWOOOOBWOOOO
OOOOWWWOWWWOOOO
OOODOOOOOOODOOO
OOOOOOOOOOOOOOO
ROOOOOOCOOOOOOR
OOOOOOOOOOOOOOO