OOOOOOOWOOOOBOO
OROOOEOWPOOOOOC
OOWWWWWWWWWWOO
OOWOOOOWOOOOWOO
OCWODOOWOOOEWAO
OOWOOOOWOWOOWOO
OOWOOWWWOWOOWOO
OOWOOCOOOWOOWOB
OOWOOOOOOWOOWOO
OOWWWWWWWWOOWOO
ODWOOEOOOOOOWOO
OOWOOOOBOWOCWOO
OOWBOOOOOWOOWRO
OOOOOOBOOWOOOOO
OOOOOOOOOWOOOOO